0000000000000000
0111000000000000
0121000000000000
0111000000000000
0000000000000000
0000000000000000
0000000000000000
0000000000000000
0000000000000000
0000000000000000
0000000000000000
0000000000000000
0000000000001110
0000000000001310
0000000000001110
0000000000000000
