0000000000000000
0111000000000000
0131000000000000
0111000000000000
0111000000000000
0111000000000000
0111111111111110
0111111111111110
0111111111111110
0000000000001110
0000000000001110
0000000000001110
0000000000001110
0000000000001210
0000000000001110
0000000000000000
