51117
51317
51117
51117
51116000000006
51111111111117
51111111111117
51111111111117
60000000061117
99999999951117
99999999951117
99999999951117
99999999951217
99999999961110