00000
01110
01310
01110
01110
01110000000000
01111111111110
01111111111110
01111111111110
00000000001110
99999999901110
99999999901110
99999999901110
99999999901210
99999999901110
99999999990000